1111111
1000001
1011101
101P101
1011101
1000CE1
1111111