1111111111
1P001000C1
1110101111
1C00000001
1111101111
10000000C1
1011111101
10000000E1
1111111111