1111111
1P00001
1111101
1C10001
1110E01
1111111