1111111
1P00001
1111101
1C00001
1011111
10000E1
1111111