1111111111111
1P0C1000000C1
1010101111101
100000C000001
1010111110101
10C000E0000C1
1111111111111