1111111111
1P0C100001
1110101111
1000000001
1111101111
1000C00001
1011111101
1000E000E1
1111111111