1111111111
1C00100001
1110101111
1000000001
1111101111
1000000001
1011111101
100000E001
1111111111