1111111111
1P00100001
1110101111
1000000001
1111101111
1000000001
1011111101
10000000E1
1111111111